1111111111
1010P11101
1011C00001
111EC000C1
1010010011
1010000001
1000100111
1000101011
1000100111
1111111111
